1 13 17
#################
#p# # # # # # #*#
# *s   ***   1 *#
#  #* # # # # * #
#* * 2*   *   **#
# # #f# # #*# # #
#*   *   **    *#
# *# # #*# # # *#
#*  *  ***   *5 #
# # # # #b# # #*#
#*4  ** *  3 * *#
#* # # # # #*# x#
#################