1 13 17
#################
#p# #*#*# # #2#*#
#  *   * ***   *#
#x # # #b# # # *#
#* *  **  *   **#
# # # # # #*# # #
#* 1 *  *** 3  *#
#  # # #*# # # *#
#*  *  ***   *  #
# # # # # # # #*#
#* 3 ** * *  2  #
#* # # # # #*#  #
#################