0 13 17
#################
#p * #*1 2*#  **#
#  * #*345*#  **#
#***   b*b      #
#      f*f      #
#*    #s*s#    *#
#*   **bfs**   *#
#*    #b*b#    *#
#      f*f      #
#      s*s   ***#
#**  #*1 2*# *  #
#**  #*345*# * q#
#################